16 16
Media/Textures/Tiles.png
35 35
0,0 0,0 0,0 0,0 0,0 0,0 0,0 0,0 0,0 0,0 0,0 0,0 0,0 0,0 0,0 0,0 0,0 0,0 0,0 0,2 2,0 0,0 0,0 0,0 0,0 0,0 0,0 0,0 0,0 0,0 0,0 0,0 0,0 0,0 0,0 
0,0 0,0 0,0 0,0 2,0 2,0 2,0 0,0 0,0 0,0 0,0 0,0 0,0 2,0 0,0 0,0 0,0 0,0 0,0 2,0 2,0 2,0 0,0 0,0 0,0 0,0 0,0 0,0 0,0 0,0 0,0 0,0 0,0 0,0 0,0 
0,0 0,0 0,0 0,0 2,0 0,0 0,0 0,0 0,0 0,0 0,0 0,0 0,0 2,0 0,0 0,0 0,0 0,0 0,0 0,0 2,0 0,0 0,0 0,0 0,0 0,0 0,0 0,0 0,0 0,0 0,0 0,0 0,0 0,0 0,0 
0,0 0,0 0,0 0,0 2,0 2,0 2,0 0,0 2,0 2,0 2,0 0,0 0,0 2,0 0,0 2,0 0,0 2,0 0,0 0,0 2,0 0,0 0,0 0,0 0,0 0,0 0,0 0,0 0,0 0,0 0,0 0,0 0,0 0,0 0,0 
0,0 0,0 0,0 0,0 0,0 0,0 2,0 0,0 2,0 0,0 2,0 0,0 0,0 2,0 0,0 2,0 0,0 2,0 0,0 0,0 2,0 0,0 0,0 0,0 0,0 0,0 0,0 0,0 0,0 0,0 0,0 0,0 0,0 0,0 0,0 
0,0 0,0 0,0 0,0 2,0 2,0 2,0 0,0 2,0 2,0 2,0 2,0 0,0 2,0 0,0 2,0 2,0 2,0 0,0 0,0 2,0 2,0 2,0 0,0 0,0 0,0 0,0 0,0 0,0 0,0 0,0 0,0 0,0 0,0 0,0 
0,0 0,0 0,0 0,0 0,0 0,0 0,0 0,0 0,0 0,0 2,0 0,0 0,0 0,0 0,0 0,0 0,0 0,0 0,0 0,0 0,0 0,0 0,0 0,0 0,0 0,0 0,0 0,0 0,0 0,0 0,0 0,0 2,0 0,0 0,0 
0,0 0,0 0,0 0,0 0,0 0,0 0,0 0,0 0,0 0,0 0,0 0,0 0,0 0,0 0,0 0,0 0,0 0,0 0,0 0,0 0,0 0,0 0,0 0,0 0,0 0,0 0,0 0,0 0,0 0,0 0,0 0,0 2,0 0,0 0,0 
0,0 0,0 0,0 0,0 0,0 0,0 0,0 0,0 0,0 0,0 0,0 0,0 0,0 0,0 0,0 0,0 0,0 0,0 0,0 0,0 0,0 0,0 0,0 0,0 0,0 0,0 0,0 0,0 0,0 0,0 2,0 2,0 2,0 2,0 2,0 
0,0 0,0 0,0 2,0 2,0 2,0 0,0 0,0 0,0 0,0 0,0 0,0 0,0 2,0 2,0 2,0 0,0 0,0 0,0 0,0 0,0 0,0 0,0 0,0 0,0 0,0 0,0 0,0 0,0 0,0 0,0 2,0 2,0 2,0 0,0 
0,0 0,0 2,0 2,0 0,0 0,0 0,0 0,0 0,0 0,0 0,0 0,0 2,0 2,0 0,0 0,0 0,0 0,0 2,0 0,0 0,0 0,0 0,0 0,0 0,0 0,0 0,0 0,0 0,0 0,0 0,0 0,0 2,0 0,0 0,0 
0,0 0,0 2,0 0,0 0,0 0,0 0,0 0,0 0,0 0,0 0,0 0,0 2,0 0,0 0,0 0,0 0,0 0,0 0,0 0,0 0,0 0,0 0,0 2,0 2,0 2,0 2,0 0,0 2,0 2,0 2,0 0,0 2,0 0,0 0,0 
0,0 0,0 2,0 0,0 0,0 0,0 0,0 0,0 0,0 0,0 0,0 0,0 2,0 0,0 0,0 0,0 0,0 0,0 0,0 0,0 0,0 0,0 0,0 2,0 0,0 0,0 2,0 0,0 2,0 0,0 0,0 0,0 2,0 0,0 0,0 
0,0 0,0 2,0 0,0 0,0 0,0 0,0 2,0 2,0 2,0 0,0 0,0 2,0 0,0 0,0 0,0 0,0 0,0 2,0 0,0 0,0 0,0 0,0 2,0 2,0 2,0 2,0 0,0 2,0 2,0 2,0 0,0 2,0 0,0 0,0 
0,0 0,0 2,0 0,0 0,0 0,0 0,0 2,0 0,0 2,0 0,0 0,0 2,0 0,0 0,0 0,0 0,0 0,0 2,0 0,0 0,0 0,0 0,0 2,0 0,0 0,0 0,0 0,0 0,0 0,0 2,0 0,0 2,0 0,0 0,0 
0,0 0,0 2,0 2,0 0,0 0,0 0,0 2,0 2,0 2,0 0,0 0,0 2,0 2,0 0,0 0,0 0,0 0,0 2,0 0,0 0,0 0,0 0,0 2,0 2,0 2,0 2,0 0,0 2,0 2,0 2,0 0,0 2,0 2,0 2,0 
0,0 0,0 0,0 2,0 2,0 2,0 0,0 2,0 0,0 0,0 0,0 0,0 0,0 2,0 2,0 2,0 0,0 0,0 2,0 0,0 0,0 0,0 0,0 0,0 0,0 0,0 0,0 0,0 0,0 0,0 0,0 0,0 0,0 0,0 0,0 
0,0 0,0 0,0 0,0 0,0 0,0 0,0 2,0 2,0 2,0 0,0 0,0 0,0 0,0 0,0 0,0 0,0 0,0 0,0 0,0 0,0 0,0 0,0 0,0 0,0 0,0 0,0 0,0 0,0 0,0 0,0 0,0 0,0 0,0 0,0 
0,0 0,0 0,0 0,0 0,0 0,0 0,0 0,0 0,0 0,0 0,0 0,0 0,0 0,0 0,0 0,0 0,0 0,0 0,0 0,0 0,0 0,0 0,0 0,0 0,0 0,0 0,0 0,0 0,0 0,0 0,0 0,0 0,0 0,0 0,0 
0,0 0,0 0,0 0,0 0,0 0,0 0,0 0,0 0,0 0,0 0,0 0,0 0,0 0,0 0,0 0,0 0,0 0,0 0,0 0,0 0,0 0,0 0,0 0,0 0,0 0,0 0,0 0,0 0,0 0,0 0,0 0,0 0,0 0,0 0,0 
0,0 0,0 0,0 0,0 0,0 0,0 0,0 0,0 0,0 0,0 0,0 0,0 0,0 0,0 0,0 0,0 0,0 0,0 0,0 0,0 0,0 0,0 0,0 0,0 0,0 0,0 0,0 0,0 0,0 0,0 0,0 0,0 0,0 0,0 0,0 
0,0 0,0 0,0 0,0 0,0 0,0 0,0 0,0 0,0 0,0 0,0 2,0 0,0 0,0 0,0 0,0 0,0 0,0 0,0 0,0 0,0 0,0 0,0 0,0 0,0 0,0 0,0 0,0 0,0 0,0 0,0 0,0 0,0 0,0 0,0 
0,0 0,0 2,0 0,0 0,0 0,0 0,0 0,0 0,0 2,0 2,0 2,0 2,0 2,0 0,0 0,0 0,0 0,0 0,0 0,0 0,0 0,0 0,0 0,0 0,0 0,0 0,0 0,0 0,0 0,0 0,0 0,0 0,0 0,0 0,0 
0,0 0,0 2,0 2,0 2,0 2,0 0,0 0,0 0,0 0,0 0,0 2,0 0,0 0,0 0,0 0,0 0,0 0,0 0,0 0,0 2,0 2,0 2,0 2,0 0,0 0,0 0,0 0,0 0,0 0,0 0,0 0,0 0,0 0,0 0,0 
0,0 0,0 2,0 0,0 0,0 2,0 0,0 2,0 2,0 2,0 0,0 2,0 0,0 0,0 0,0 2,0 2,0 2,0 0,0 0,0 2,0 0,0 0,0 2,0 0,0 0,0 0,0 0,0 0,0 0,0 0,0 0,0 0,0 0,0 0,0 
0,0 0,0 2,0 0,0 0,0 2,0 0,0 2,0 0,0 2,0 0,0 2,0 0,0 0,0 0,0 2,0 0,0 0,0 0,0 0,0 2,0 2,0 2,0 2,0 0,0 0,0 0,0 0,0 0,0 0,0 0,0 0,0 0,0 0,0 0,0 
0,0 0,0 2,0 0,0 0,0 2,0 0,0 2,0 0,0 2,0 0,0 2,0 0,0 0,0 0,0 2,0 0,0 0,0 0,0 0,0 2,0 0,0 0,0 0,0 0,0 0,0 0,0 0,0 0,0 0,0 0,0 0,0 0,0 0,0 0,0 
0,0 0,0 2,0 0,0 0,0 2,0 0,0 2,0 2,0 2,0 0,0 2,0 2,0 2,0 0,0 2,0 0,0 0,0 0,0 0,0 2,0 2,0 2,0 2,0 0,0 0,0 0,0 0,0 0,0 0,0 0,0 0,0 0,0 0,0 0,0 
0,0 0,0 0,0 0,0 0,0 0,0 0,0 0,0 0,0 0,0 0,0 0,0 0,0 0,0 0,0 0,0 0,0 0,0 0,0 0,0 0,0 0,0 0,0 0,0 0,0 0,0 0,0 0,0 0,0 0,0 0,0 0,0 0,0 0,0 0,0 
0,0 0,0 0,0 0,0 0,0 0,0 0,0 2,0 2,0 2,0 0,0 1,0 1,0 0,0 0,0 0,0 4,0 0,0 0,0 3,2 0,0 0,0 0,0 1,1 1,1 0,0 0,0 0,0 0,0 0,0 2,0 2,0 0,0 0,0 0,0 
0,0 0,0 0,0 0,0 0,0 0,0 0,0 2,0 0,0 0,0 0,0 1,0 0,0 1,0 0,0 0,0 4,0 0,0 3,2 3,2 3,2 0,0 0,0 1,1 0,0 0,0 0,0 0,0 0,0 0,0 2,0 0,0 2,0 0,0 0,0 
0,0 0,0 0,0 0,0 0,0 0,0 0,0 2,0 2,0 2,0 0,0 1,0 0,0 1,0 0,0 0,0 4,0 0,0 0,0 3,2 0,0 0,0 0,0 1,1 1,1 0,0 3,2 0,0 3,2 0,0 2,0 2,0 0,0 0,0 0,0 
0,0 0,0 0,0 0,0 0,0 0,0 0,0 2,0 0,0 0,0 0,0 1,0 0,0 1,0 0,0 0,0 4,0 0,0 0,0 3,2 0,0 0,0 0,0 1,1 0,1 0,0 3,2 0,0 3,2 0,0 2,0 0,0 2,0 0,0 0,0 
0,0 0,0 0,0 0,0 0,0 0,0 0,0 2,0 2,0 2,0 0,0 1,0 1,0 0,0 0,0 0,0 4,0 0,0 0,0 3,2 3,2 3,2 0,0 1,1 1,1 0,0 3,2 3,2 3,2 0,0 2,0 0,0 0,0 2,0 0,0 
0,0 0,0 0,0 0,0 0,0 0,0 0,0 0,0 0,0 0,0 0,0 0,0 0,0 0,0 0,0 0,0 0,0 0,0 0,0 0,0 0,0 0,0 0,0 0,0 0,0 0,0 0,0 0,0 0,0 0,0 0,0 0,0 0,0 0,0 0,0 
